"filename", "language", "Java Properties", "Java", "comment", "blank", "total"
"/home/mdd/文档/fxs毕设/backend/demo/src/main/java/com/example/demo/DemoApplication.java", "Java", 0, 9, 0, 5, 14
"/home/mdd/文档/fxs毕设/backend/demo/src/main/java/com/example/demo/controller/DemoController.java", "Java", 0, 10, 0, 5, 15
"/home/mdd/文档/fxs毕设/backend/demo/src/main/java/com/example/demo/controller/FileController.java", "Java", 0, 26, 0, 6, 32
"/home/mdd/文档/fxs毕设/backend/demo/src/main/java/com/example/demo/controller/Getmapping.java", "Java", 0, 3, 0, 3, 6
"/home/mdd/文档/fxs毕设/backend/demo/src/main/java/com/example/demo/controller/SubmitController.java", "Java", 0, 52, 0, 10, 62
"/home/mdd/文档/fxs毕设/backend/demo/src/main/java/com/example/demo/controller/TagController.java", "Java", 0, 47, 0, 9, 56
"/home/mdd/文档/fxs毕设/backend/demo/src/main/java/com/example/demo/controller/UserController.java", "Java", 0, 60, 0, 12, 72
"/home/mdd/文档/fxs毕设/backend/demo/src/main/java/com/example/demo/entity/Picture.java", "Java", 0, 12, 0, 3, 15
"/home/mdd/文档/fxs毕设/backend/demo/src/main/java/com/example/demo/entity/Submit.java", "Java", 0, 13, 0, 3, 16
"/home/mdd/文档/fxs毕设/backend/demo/src/main/java/com/example/demo/entity/SubmitAndTagAndUserAndPicture.java", "Java", 0, 14, 0, 4, 18
"/home/mdd/文档/fxs毕设/backend/demo/src/main/java/com/example/demo/entity/Tag.java", "Java", 0, 14, 0, 3, 17
"/home/mdd/文档/fxs毕设/backend/demo/src/main/java/com/example/demo/entity/TagAndPicture.java", "Java", 0, 12, 0, 4, 16
"/home/mdd/文档/fxs毕设/backend/demo/src/main/java/com/example/demo/entity/User.java", "Java", 0, 16, 0, 4, 20
"/home/mdd/文档/fxs毕设/backend/demo/src/main/java/com/example/demo/mapper/PictureMapper.java", "Java", 0, 20, 0, 9, 29
"/home/mdd/文档/fxs毕设/backend/demo/src/main/java/com/example/demo/mapper/SubmitMapper.java", "Java", 0, 22, 0, 10, 32
"/home/mdd/文档/fxs毕设/backend/demo/src/main/java/com/example/demo/mapper/TagMapper.java", "Java", 0, 27, 0, 12, 39
"/home/mdd/文档/fxs毕设/backend/demo/src/main/java/com/example/demo/mapper/UserMapper.java", "Java", 0, 29, 0, 13, 42
"/home/mdd/文档/fxs毕设/backend/demo/src/main/java/com/example/demo/service/FileService.java", "Java", 0, 44, 0, 9, 53
"/home/mdd/文档/fxs毕设/backend/demo/src/main/java/com/example/demo/service/SubmitService.java", "Java", 0, 60, 0, 13, 73
"/home/mdd/文档/fxs毕设/backend/demo/src/main/java/com/example/demo/service/TagService.java", "Java", 0, 47, 0, 10, 57
"/home/mdd/文档/fxs毕设/backend/demo/src/main/java/com/example/demo/service/UserService.java", "Java", 0, 43, 0, 11, 54
"/home/mdd/文档/fxs毕设/backend/demo/src/main/java/com/example/demo/util/Sha256.java", "Java", 0, 21, 0, 3, 24
"/home/mdd/文档/fxs毕设/backend/demo/src/main/resources/application.properties", "Java Properties", 6, 0, 0, 3, 9
"/home/mdd/文档/fxs毕设/backend/demo/src/test/java/com/example/demo/DemoApplicationTests.java", "Java", 0, 9, 0, 5, 14
"Total", "-", 6, 610, 0, 169, 785